1111111111111111111111111111111111
1E00000000000X0C00000C0000X0000001
1010010100100000101001000000010101
101001001010101000100100X000010101
1P0000000C00C000X000000000000000C1
111100C000X00010001000101001100001
111000X0C000C000C00100100010000001
100XC000C00100C00100C0001C00010C01
1000001000011000001000110000011111
1111111111111111111111111111111111